4555555555555555555555555555555555555555
4555555555555555555600000000000000045555
4555555555555560000000000000000000000!!!
4555555555556000000000000000000000000!!!
4556000000000000000000000000000000222223
4560000000000000222222000220002200555556
4600000000000000555555JJJ55JJJ55JJ555556
4600000002222222555555555555555555555556
4600000025560000000000000045555555555556
4AB0001256000000000000000004555555555556
4600000000000000000000000000004555555556
4600000000000000000000000000000045555556
4AB222222223000DEEEF00000000000000455556
4555555555560000000000000000000000000456
4555555555560000000000000000000000000456
4555555555600000000000022200000000000456
4555555560000000000000055500000000000456
4560000000000000000000055500000000000456
4560000000000000002220055500222000000456
4560000000000000005550055500555000000456
4560000000000000005550055500555000000456
45AB222223HHH222222222222222222222227856
4555555556III555555555555555555555555556
4555555556III555555555555555555555555556
