5555555555555555555555555555555555555555555555555555555555555555555555555
5555555555555555555555555555555555555555555555555555555555555555555555555
5555555555555555555555555555555555555555555555555555555555555555555555555
5555555555555555555555555555555555555555555555555555555555555555555555555
5555555555555555555555555555555555555555555555555555555555555555555555555
5555555555555555555000000000000000000000000000000000000000000000000055555
55555555555555555500000000000000000000000000000000000000000000000000000!!
55555555555555555000000000000000000000000000000000000000000000000000000!!
55555555555555556000000000000000000000000000000000000000000000000000000!!
55555556000000000000000000000000000000222223000DEEF000DEEF000DEEF00045555
5555556000000000000022222200022000220055555600000000000000000000000045555
55555600000000000000555555JJJ55JJJ55JJ55555600000000000000000000000045555
5555560000000222222255555555555555555555555600000000000000000000000045555
5555560000002556000000000000004555555555555600000000000000000000000004555
55555AB0001256000000000000000004555555555556JJJJJJJJ000000000000000000455
5555560000000000000000000000000000455555555555555555600000000000000000046
5555560000000000000000000000000000004555555555555555600000000000000000046
55555AB222222223000DEEEF0000000000000045555555555555600000000000000000046
5555555555555556000000000000000000000000045555555555600000000000000000046
5555555555555556000000000000000000000000045555555555600000000000000000046
5555555555555560000000000002220000000000045555555555600000000000000000046
5555555555556000000000000005550000000000045555555555600000000000000000046
5555556000000000000000000005550000000000045555555555600000000000000000046
5555556000000000000000222005550022200000045555555555600000000000000000046
5555556000000000000000555005550055500000045555555555600000000000000000046
5555556000000000000000555005550055500000045555555555600000000000000000046
555555AB222223HHH22222222222222222222222785555555555600000000000000000046
55555555555556III55555555555555555555555555555555555600000000000000000046
55555555555556III555555555555555555555555555555555556HHHHHHHHHHHHHHHHHHHH
5555IIIIIIIIIIIIIIIIIIIIIIIIIIIIIIIIIIIIIIIIIIIIIIIIIIIIIIIIIIIIIIIIIIIII
5555IIIIIIIIIIIIIIIIIIIIIIIIIIIIIIIIIIIIIIIIIIIIIIIIIIIIIIIIIIIIIIIIIIIII
5555IIIIIIIIIIIIIIIIIIIIIIIIIIIIIIIIIIIIIIIIIIIIIIIIIIIIIIIIIIIIIIIIIIIII
